      #######
  ### #B #  #                 ####
  # ###. #  #                 #  #
  #    .## ####################  #
  #    .... #..................A #
 ##  #####. #.################   #
 #   #   #.##.#              #   #
 #   #   #....#              #####
 #   #   #    #
 #####   ######
