###########
#     #   #
#  #      #
#A #..... #
#. #.  #. #
#.... ##.###
####### .  #
#       ...#
#      ###.#
#         .#
#       B..#
############
